6,7,
1,1,1,1,1,1,
1,3,2,2,4,1,
1,3,2,2,4,1,
1,5,6,6,7,1,
1,5,8,9,10,1,
1,11,0,0,12,1,
1,1,-1,-1,1,1,
