6,7,
1,1,1,1,1,1,
1,3,2,2,4,1,
1,5,2,2,6,1,
1,7,8,9,10,1,
1,11,12,13,14,1,
1,15,0,0,16,1,
1,1,-1,-1,1,1,
