6,7,
1,1,1,1,1,1,
1,3,2,2,4,1,
1,3,2,2,4,1,
1,5,6,7,8,1,
1,9,10,11,12,1,
1,13,0,0,14,1,
1,1,-1,-1,1,1,
